{
    "pieces": [
        ["n", "s", "g", "k", "g", "s", "n"],
        [".", "r", ".", ".", ".", "b", "."],
        ["p", "p", "p", "p", "p", "p", "p"],
        [".", ".", ".", ".", ".", ".", "."],
        ["P", "P", "P", "P", "P", "P", "P"],
        [".", "B", ".", ".", ".", "R", "."],
        ["N", "S", "G", "K", "G", "S", "N"]
    ]
}  